▤▤▤▤▤▤▤▤▤▤▤▤▤▤▤▤▤▤▤▤▤▤▤▤▤▤▤▤▤▤▤▤▤▤▤▤▤▤▤▤▤▤▤▤▤▤▤▤▤▤▤▤▤▤▤▤▤▤▤▤▤▤▤▤▤▤▤▤▤▤▤▤▤▤▤▤▤▤▤▤
▤ ⏺                          ▤                            ▤                    ▤
▤   ▤▤▤▤                     ▤                            ▤                    ▤
▤   ▤▤▤▤                                                     ▤▤▤▤▤▤▤▤▤▤▤▤▤▤▤▤▤▤▤
▤                            ▤                                                 ▤
▤                            ▤                                                 ▤
▤                            ▤                            ▤                    ▤
▤                            ▤                            ▤                    ▤
▤              ☠             ▤                            ▤                    ▤
▤                            ▤                            ▤                    ▤
▤                            ▤                            ▤                    ▤
▤                            ▤                            ▤                    ▤
▤                            ▤                            ▤                    ▤
▤                            ▤                            ▤                    ▤
▤                            ▤                            ▤                    ▤
▤                            ▤                            ▤                    ▤
▤  ▤▤▤▤▤▤▤▤▤▤▤▤▤▤▤▤▤▤▤▤▤▤▤   ▤                            ▤                    ▤
▤  ▤                     ▤   ▤                            ▤                    ▤
▤  ▤                     ▤   ▤                            ▤                    ▤
▤  ▤                     ▤   ▤              ☠             ▤▤▤▤▤▤▤▤▤    ▤▤▤▤▤▤▤▤▤
▤  ▤                     ▤▤▤▤▤                            ▤                    ▤
▤  ▤                         ▤                            ▤                    ▤
▤  ▤                    ☺    ▤                            ▤                    ▤
▤  ▤  ▤▤▤▤▤▤▤▤▤▤▤▤▤▤▤▤▤▤▤▤▤▤▤▤                            ▤                    ▤
▤  ▤                         ▤                            ▤          ☠         ▤
▤  ▤                         ▤                            ▤                    ▤
▤  ▤                         ▤                            ▤                    ▤
▤  ▤                         ▤                            ▤                    ▤
▤                            ▤              ☺             ▤          ✷         ▤
▤▤▤▤▤▤▤▤▤▤▤▤▤▤▤▤▤▤▤▤▤▤▤▤▤▤▤▤▤▤▤▤▤▤▤▤▤▤▤▤▤▤▤▤▤▤▤▤▤▤▤▤▤▤▤▤▤▤▤▤▤▤▤▤▤▤▤▤▤▤▤▤▤▤▤▤▤▤▤▤