▤▤▤▤▤▤▤▤▤▤▤▤▤▤▤▤▤▤▤▤▤▤▤▤▤▤▤▤▤▤▤▤▤▤▤▤▤▤▤▤▤▤▤▤▤▤▤▤▤▤▤▤▤▤▤▤▤▤▤▤▤▤▤▤▤▤▤▤▤▤▤▤▤▤▤▤▤▤▤▤
▤                            ▤                            ▤                    ▤
▤   ▤▤▤▤                     ▤                            ▤                    ▤
▤   ▤▤▤▤                                                     ▤▤▤▤▤▤▤▤▤▤▤▤▤▤▤▤▤▤▤
▤                            ▤                                                 ▤
▤                            ▤                                                 ▤
▤        ▤▤▤▤▤▤▤▤            ▤                            ▤                    ▤
▤        ▤      ▤            ▤                            ▤                    ▤
▤        ▤      ▤            ▤                            ▤                    ▤
▤        ▤      ▤▤▤▤▤▤▤▤▤▤▤  ▤                            ▤                    ▤
▤        ▤                   ▤                            ▤                    ▤
▤        ▤                   ▤                            ▤                    ▤
▤        ▤▤▤▤▤▤▤▤▤▤▤▤▤▤▤▤▤▤▤▤▤                            ▤                    ▤
▤                            ▤                            ▤                    ▤
▤                            ▤                            ▤                    ▤
▤                            ▤                            ▤                    ▤
▤  ▤▤▤▤▤▤▤▤▤▤▤▤▤▤▤▤▤▤▤▤▤▤▤   ▤                            ▤                    ▤
▤  ▤                     ▤   ▤                            ▤                    ▤
▤  ▤                     ▤   ▤                            ▤                    ▤
▤  ▤                     ▤   ▤                            ▤▤▤▤▤▤▤▤▤    ▤▤▤▤▤▤▤▤▤
▤  ▤                     ▤▤▤▤▤                            ▤                    ▤
▤  ▤                         ▤                            ▤                    ▤
▤  ▤                    ☺    ▤                            ▤                    ▤
▤  ▤  ▤▤▤▤▤▤▤▤▤▤▤▤▤▤▤▤▤▤▤▤▤▤▤▤                            ▤                    ▤
▤  ▤                         ▤                            ▤          ☠         ▤
▤  ▤                         ▤                            ▤                    ▤
▤  ▤                         ▤                            ▤                    ▤
▤  ▤                         ▤                            ▤                    ▤
▤                            ▤                            ▤          ✷         ▤
▤▤▤▤▤▤▤▤▤▤▤▤▤▤▤▤▤▤▤▤▤▤▤▤▤▤▤▤▤▤▤▤▤▤▤▤▤▤▤▤▤▤▤▤▤▤▤▤▤▤▤▤▤▤▤▤▤▤▤▤▤▤▤▤▤▤▤▤▤▤▤▤▤▤▤▤▤▤▤▤